dt,uv,1,2,3,2more
2017/1/1,3000,2357,243,400,643
2017/1/2,3784,2791,381,612,993
2017/1/3,9533,6186,958,2389,3347
2017/1/4,10825,7379,1047,2399,3446
2017/1/5,10814,7509,1011,2294,3305
2017/1/6,10180,7137,945,2098,3043
2017/1/7,4254,3413,275,566,841
2017/1/8,1503,1242,93,168,261
2017/1/9,8355,5215,924,2216,3140
2017/1/10,9866,6744,927,2195,3122
2017/1/11,9606,6513,931,2162,3093
2017/1/12,9203,6296,841,2066,2907
2017/1/13,8898,6354,771,1773,2544
2017/1/14,4541,3817,250,474,724
2017/1/15,1972,1560,148,264,412
2017/1/16,8012,5381,824,1807,2631
2017/1/17,7739,5630,642,1467,2109
2017/1/18,6954,4989,614,1351,1965
2017/1/19,5185,3832,441,912,1353
2017/1/20,3699,2928,275,496,771
2017/1/21,34,28,3,3,6
2017/1/22,24,13,3,8,11
2017/1/23,28,11,4,13,17
2017/1/24,15,9,2,4,6
2017/1/25,14,5,2,7,9
2017/2/1,5,2,1,2,3
2017/2/3,3168,1848,397,923,1320
2017/2/4,8025,5293,755,1977,2732
2017/2/5,5150,3679,433,1038,1471
2017/2/6,12223,7727,1190,3306,4496
2017/2/7,14237,9437,1260,3540,4800
2017/2/8,13660,8890,1290,3480,4770
2017/2/9,14240,9426,1274,3540,4814
2017/2/10,12884,8806,1115,2963,4078
2017/2/11,7616,6166,494,956,1450
2017/2/12,5931,4332,515,1084,1599
2017/2/13,12116,7366,1375,3375,4750
2017/2/14,14624,10165,1348,3111,4459
2017/2/15,13612,8968,1363,3281,4644
2017/2/16,11376,6669,1393,3314,4707
2017/2/17,14920,10446,1310,3164,4474
2017/2/18,8729,6844,632,1253,1885
2017/2/19,9378,7630,558,1190,1748
2017/2/20,12512,7683,1425,3404,4829
2017/2/21,10586,5870,1403,3313,4716
2017/2/22,10158,5534,1407,3217,4624
2017/2/23,9930,5263,1356,3311,4667
2017/2/24,9285,5138,1240,2907,4147
2017/2/25,4545,2759,618,1168,1786
2017/2/26,4216,2513,549,1154,1703
2017/2/27,10154,5360,1435,3359,4794
2017/2/28,9838,5230,1363,3245,4608
2017/3/1,9948,5310,1389,3249,4638
2017/3/2,9920,5223,1377,3320,4697
2017/3/3,9512,5251,1317,2944,4261
2017/3/4,4262,2586,554,1122,1676
2017/3/5,4187,2520,578,1089,1667
2017/3/6,10194,5467,1457,3270,4727
2017/3/7,9844,5333,1414,3097,4511
2017/3/8,8891,4947,1226,2718,3944
2017/3/9,9620,5251,1302,3067,4369
2017/3/10,8971,4837,1239,2895,4134
2017/3/11,4219,2472,585,1162,1747
2017/3/12,3753,2264,509,980,1489
2017/3/13,9635,5108,1324,3203,4527
2017/3/14,9675,5212,1342,3121,4463
2017/3/15,8631,4709,1116,2806,3922
2017/3/16,8481,4598,1201,2682,3883
2017/3/17,8446,4600,1161,2685,3846
2017/3/18,4011,2464,546,1001,1547
2017/3/19,4056,2561,521,974,1495
2017/3/20,7852,4277,1097,2478,3575
2017/3/21,9251,4963,1283,3005,4288
2017/3/22,9324,5093,1259,2972,4231
2017/3/23,8606,4756,1209,2641,3850
2017/3/24,7048,4079,946,2023,2969
2017/3/25,4036,2579,524,933,1457
2017/3/26,3812,2389,506,917,1423
2017/3/27,9023,4944,1198,2881,4079
2017/3/28,8923,4961,1185,2777,3962
2017/3/29,8389,4588,1158,2643,3801
2017/3/30,8044,4439,1081,2524,3605
2017/3/31,7436,4120,1006,2310,3316
2017/4/1,4552,2513,644,1395,2039
2017/4/2,2656,1731,335,590,925
2017/4/3,2629,1722,324,583,907
2017/4/4,2981,1922,377,682,1059
2017/4/5,7906,4314,1091,2501,3592
2017/4/6,7878,4242,1090,2546,3636
2017/4/7,7484,4148,1051,2285,3336
2017/4/8,3398,2156,413,829,1242
2017/4/9,3106,1931,390,785,1175
2017/4/10,8241,4484,1135,2622,3757
2017/4/11,8115,4383,1159,2573,3732
2017/4/12,8216,4506,1128,2582,3710
2017/4/13,8036,4387,1083,2566,3649
2017/4/14,7619,4172,1050,2397,3447
2017/4/15,2830,1737,382,711,1093
2017/4/16,2793,1727,370,696,1066
2017/4/17,8173,4346,1182,2645,3827
2017/4/18,7953,4190,1081,2682,3763
2017/4/19,7873,4320,1070,2483,3553
2017/4/20,7719,4161,1095,2463,3558
2017/4/21,7499,4162,1060,2277,3337
2017/4/22,2675,1569,404,702,1106
2017/4/23,2804,1673,366,765,1131
2017/4/24,7933,4258,1132,2543,3675
2017/4/25,7507,3953,1134,2420,3554
2017/4/26,7771,4081,1092,2598,3690
2017/4/27,7527,3988,1109,2430,3539
2017/4/28,6589,3649,957,1983,2940
2017/4/29,2458,1520,303,635,938
2017/4/30,1407,889,178,340,518
2017/5/1,1818,1119,279,420,699
2017/5/2,7272,3779,1089,2404,3493
2017/5/3,7996,4261,1148,2587,3735
2017/5/4,8864,4748,1253,2863,4116
2017/5/5,7873,4181,1126,2566,3692
2017/5/6,3281,1928,485,868,1353
2017/5/7,3197,1897,438,862,1300
2017/5/8,8222,4089,1315,2818,4133
2017/5/9,8300,4256,1227,2817,4044
2017/5/10,8186,4175,1247,2764,4011
2017/5/11,8012,4191,1186,2635,3821
2017/5/12,7863,4212,1174,2477,3651
2017/5/13,3161,1824,423,914,1337
2017/5/14,2855,1646,373,836,1209
2017/5/15,8458,4268,1303,2887,4190
2017/5/16,8482,4308,1246,2928,4174
2017/5/17,8059,3870,1176,3013,4189
2017/5/18,7942,3860,1193,2889,4082
2017/5/19,7333,3597,1073,2663,3736
2017/5/20,2629,1500,359,770,1129
2017/5/21,3133,1639,430,1064,1494
2017/5/22,8017,4094,1150,2773,3923
2017/5/23,7946,3879,1140,2927,4067
2017/5/24,8061,3809,1263,2989,4252
2017/5/25,7495,3552,1203,2740,3943
2017/5/26,7416,3612,1100,2704,3804
2017/5/27,5044,2563,749,1732,2481
2017/5/28,2352,1280,329,743,1072
2017/5/29,2427,1348,337,742,1079
2017/5/30,2358,1283,340,735,1075
2017/5/31,7674,3605,1222,2847,4069
2017/6/1,7502,3589,1199,2714,3913
2017/6/2,7299,3627,1095,2577,3672
2017/6/3,3423,1830,517,1076,1593
2017/6/4,3193,1778,450,965,1415
2017/6/5,8481,4114,1299,3068,4367
2017/6/6,8190,3940,1219,3031,4250
2017/6/7,7871,3909,1196,2766,3962
2017/6/8,8039,3938,1243,2858,4101
2017/6/9,7559,3693,1120,2746,3866
2017/6/10,3226,1771,437,1018,1455
2017/6/11,2948,1591,410,947,1357
2017/6/12,8377,4030,1288,3059,4347
2017/6/13,8097,3931,1202,2964,4166
2017/6/14,8144,4019,1220,2905,4125
2017/6/15,8142,3983,1185,2974,4159
2017/6/16,7479,3690,1055,2734,3789
2017/6/17,3421,1884,480,1057,1537
2017/6/18,2635,1481,388,766,1154
2017/6/19,8106,3877,1163,3066,4229
2017/6/20,8149,4001,1167,2981,4148
2017/6/21,8105,3868,1145,3092,4237
2017/6/22,8084,3910,1153,3021,4174
2017/6/23,7197,3605,1010,2582,3592
2017/6/24,3002,1729,409,864,1273
2017/6/25,2608,1450,340,818,1158
2017/6/26,7216,3512,1002,2702,3704
2017/6/27,7056,3515,1021,2520,3541
2017/6/28,3508,1518,461,1529,1990
2017/6/29,2631,1127,356,1148,1504
2017/6/30,3354,1587,482,1285,1767
2017/7/1,2115,1187,299,629,928
2017/7/2,1818,1016,248,554,802
2017/7/3,6480,3049,891,2540,3431
2017/7/4,6864,3357,955,2552,3507
2017/7/5,6942,3415,986,2541,3527
2017/7/6,6547,3191,949,2407,3356
2017/7/7,5808,2894,844,2070,2914
2017/7/8,3152,1737,423,992,1415
2017/7/9,2765,1589,376,800,1176
2017/7/10,7233,3506,1017,2710,3727
2017/7/11,7181,3507,973,2701,3674
2017/7/12,7361,3606,1037,2718,3755
2017/7/13,6915,3623,941,2351,3292
2017/7/14,7247,4233,910,2104,3014
2017/7/15,3774,2343,445,986,1431
2017/7/16,2714,1602,370,742,1112
2017/7/17,7645,3836,1007,2802,3809
2017/7/18,7277,3664,984,2629,3613
2017/7/19,6917,3485,954,2478,3432
2017/7/20,6724,3450,901,2373,3274
2017/7/21,6125,3255,826,2044,2870
2017/7/22,2847,1616,413,818,1231
2017/7/23,2382,1366,332,684,1016
2017/7/24,7239,3562,1012,2665,3677
2017/7/25,7100,3583,995,2522,3517
2017/7/26,6991,3436,949,2606,3555
2017/7/27,6786,3535,864,2387,3251
2017/7/28,6301,3234,885,2182,3067
2017/7/29,3144,1790,462,892,1354
2017/7/30,2517,1457,361,699,1060
2017/7/31,7950,3909,1042,2999,4041
2017/8/1,7387,3659,1024,2704,3728
2017/8/2,7460,3736,1045,2679,3724
2017/8/3,7544,3727,1055,2762,3817
2017/8/4,7019,3503,1052,2464,3516
2017/8/5,3479,2003,479,997,1476
2017/8/6,2762,1587,410,765,1175
2017/8/7,8095,4012,1138,2945,4083
2017/8/8,8003,4077,1152,2774,3926
2017/8/9,8028,4029,1193,2806,3999
2017/8/10,7695,3848,1082,2765,3847
2017/8/11,7066,3559,1066,2441,3507
2017/8/12,4055,2399,541,1115,1656
2017/8/13,3031,1814,446,771,1217
2017/8/14,8819,4591,1235,2993,4228
2017/8/15,8017,4002,1186,2829,4015
2017/8/16,8104,4193,1182,2729,3911
2017/8/17,7966,4119,1173,2674,3847
2017/8/18,7296,3667,1099,2530,3629
2017/8/19,3639,2019,511,1109,1620
2017/8/20,2715,1554,351,810,1161
2017/8/21,7782,3759,1168,2855,4023
2017/8/22,7499,3683,1126,2690,3816
2017/8/23,7609,3726,1141,2742,3883
2017/8/24,7741,3859,1137,2745,3882
2017/8/25,6944,3465,1003,2476,3479
2017/8/26,3569,1892,493,1184,1677
2017/8/27,2667,1437,391,839,1230
2017/8/28,7193,3478,1051,2664,3715
2017/8/29,8495,4009,1322,3164,4486
2017/8/30,8506,4120,1339,3047,4386
2017/8/31,7965,3953,1143,2869,4012
2017/9/1,6788,3236,1016,2536,3552
2017/9/2,3860,1963,575,1322,1897
2017/9/3,2959,1588,450,921,1371
2017/9/4,8459,3896,1315,3248,4563
2017/9/5,8544,3909,1286,3349,4635
2017/9/6,8421,3979,1328,3114,4442
2017/9/7,7917,3789,1225,2903,4128
2017/9/8,7204,3458,1117,2629,3746
2017/9/9,3903,1962,564,1377,1941
2017/9/10,2677,1421,371,885,1256
2017/9/11,8340,3859,1258,3223,4481
2017/9/12,8476,3911,1301,3264,4565
2017/9/13,7734,3661,1193,2880,4073
2017/9/14,7584,3544,1137,2903,4040
2017/9/15,6687,3212,978,2497,3475
2017/9/16,3209,1569,480,1160,1640
2017/9/17,2457,1257,395,805,1200
2017/9/18,7731,3624,1121,2986,4107
2017/9/19,7497,3572,1133,2792,3925
2017/9/20,7446,3565,1173,2708,3881
2017/9/21,7634,3681,1086,2867,3953
2017/9/22,7281,3611,1074,2596,3670
2017/9/23,3332,1729,507,1096,1603
2017/9/24,2400,1264,365,771,1136
2017/9/25,7817,3814,1199,2804,4003
2017/9/26,7646,3662,1088,2896,3984
2017/9/27,6931,3377,1078,2476,3554
2017/9/28,6559,3256,953,2350,3303
2017/9/29,4240,2074,571,1595,2166
2017/9/30,1972,955,326,691,1017
2017/10/1,46,28,5,13,18
2017/10/2,24,14,2,8,10
2017/10/3,17,7,3,7,10
2017/10/4,668,375,97,196,293
2017/10/5,1308,705,174,429,603
2017/10/6,1451,752,237,462,699
2017/10/7,1777,908,249,620,869
2017/10/8,2294,1236,300,758,1058
2017/10/9,6551,3145,949,2457,3406
2017/10/10,6712,3087,988,2637,3625
2017/10/11,6629,3118,993,2518,3511
2017/10/12,7018,3387,1080,2551,3631
2017/10/13,6659,3267,1006,2386,3392
2017/10/14,3304,1668,477,1159,1636
2017/10/15,2961,1616,392,953,1345
2017/10/16,7440,3515,1078,2847,3925
2017/10/17,4924,2204,742,1978,2720
2017/10/18,7131,3339,1068,2724,3792
2017/10/19,7325,3491,1128,2706,3834
2017/10/20,6530,3181,1024,2325,3349
2017/10/21,3139,1681,436,1022,1458
2017/10/22,2735,1442,453,840,1293
2017/10/23,7583,3550,1082,2951,4033
2017/10/24,7536,3622,1139,2775,3914
2017/10/25,7380,3708,1083,2589,3672
2017/10/26,7151,3375,1062,2714,3776
2017/10/27,6456,3095,973,2388,3361
2017/10/28,3042,1639,437,966,1403
2017/10/29,2626,1392,410,824,1234
2017/10/30,7214,3465,1046,2703,3749
2017/10/31,6976,3387,1039,2550,3589
2017/11/1,6872,3328,1018,2526,3544
2017/11/2,6939,3317,1000,2622,3622
2017/11/3,6559,3273,898,2388,3286
2017/11/4,3108,1643,464,1001,1465
2017/11/5,2781,1451,421,909,1330
2017/11/6,7492,3594,1092,2806,3898
2017/11/7,7169,3436,1048,2685,3733
2017/11/8,7004,3323,1058,2623,3681
2017/11/9,6877,3366,986,2525,3511
2017/11/10,6283,3182,959,2142,3101
2017/11/11,3241,1867,486,888,1374
2017/11/12,3015,1666,446,903,1349
2017/11/13,7540,3747,1067,2726,3793
2017/11/14,6836,3279,989,2568,3557
2017/11/15,6898,3319,949,2630,3579
2017/11/16,6999,3433,983,2583,3566
2017/11/17,6694,3312,993,2389,3382
2017/11/18,3228,1783,483,962,1445
2017/11/19,2688,1484,389,815,1204
2017/11/20,7080,3450,997,2633,3630
2017/11/21,7478,3694,1087,2697,3784
2017/11/22,7794,3777,1182,2835,4017
2017/11/23,7705,3871,1128,2706,3834
2017/11/24,7273,3709,1101,2463,3564
2017/11/25,3948,2281,588,1079,1667
2017/11/26,2787,1497,431,859,1290
2017/11/27,7664,3581,1062,3021,4083
2017/11/28,7701,3745,1126,2830,3956
2017/11/29,7795,3827,1171,2797,3968
2017/11/30,7803,3774,1207,2822,4029
2017/12/1,6955,3406,1022,2527,3549
2017/12/2,2941,1585,416,940,1356
2017/12/3,2118,1106,289,723,1012
2017/12/4,7017,3237,1013,2767,3780
2017/12/5,7382,3510,1086,2786,3872
2017/12/6,7660,3690,1134,2836,3970
2017/12/7,7633,3706,1129,2798,3927
2017/12/8,7088,3467,1060,2561,3621
2017/12/9,3367,1778,477,1112,1589
2017/12/10,3256,1749,457,1050,1507
2017/12/11,7366,3385,1077,2904,3981
2017/12/12,7271,3381,1030,2860,3890
2017/12/13,7543,3543,1174,2826,4000
2017/12/14,7478,3584,1145,2749,3894
2017/12/15,7294,3572,1078,2644,3722
2017/12/16,4063,2125,650,1288,1938
2017/12/17,3278,1741,486,1051,1537
2017/12/18,7582,3610,1153,2819,3972
2017/12/19,7585,3628,1114,2843,3957
2017/12/20,7814,3679,1139,2996,4135
2017/12/21,7898,3746,1174,2978,4152
2017/12/22,7027,3459,1004,2564,3568
2017/12/23,4025,2159,618,1248,1866
2017/12/24,3176,1655,465,1056,1521
2017/12/25,7656,3685,1098,2873,3971
2017/12/26,8077,3867,1157,3053,4210
2017/12/27,8332,3973,1251,3108,4359
2017/12/28,8049,4048,1191,2810,4001
2017/12/29,6768,3264,1091,2413,3504
2017/12/30,3738,2049,560,1129,1689
2017/12/31,2279,1226,362,691,1053
2018/1/1,2230,1148,372,710,1082
2018/1/2,7306,3415,1081,2810,3891
2018/1/3,7318,3484,1100,2734,3834
2018/1/4,7204,3412,1081,2711,3792
2018/1/5,7204,3487,1107,2610,3717
2018/1/6,3480,1880,515,1085,1600
2018/1/7,2655,1390,420,845,1265
2018/1/8,7548,3617,1109,2822,3931
2018/1/9,5046,2390,740,1916,2656
2018/1/10,7236,3462,1125,2649,3774
2018/1/11,7385,3637,1093,2655,3748
2018/1/12,6378,3188,933,2257,3190
2018/1/13,3119,1696,516,907,1423
2018/1/14,2408,1299,373,736,1109
2018/1/15,7507,3505,1124,2878,4002
2018/1/16,7367,3545,1038,2784,3822
2018/1/17,7081,3402,1033,2646,3679
2018/1/18,7104,3400,1070,2634,3704
2018/1/19,6537,3161,972,2404,3376
2018/1/20,2961,1631,377,953,1330
2018/1/21,2335,1233,328,774,1102
2018/1/22,6900,3220,1050,2630,3680
2018/1/23,7111,3441,1050,2620,3670
2018/1/24,7233,3633,1084,2516,3600
2018/1/25,7521,3795,1175,2551,3726
2018/1/26,6910,3573,1178,2159,3337
2018/1/27,3998,2299,574,1125,1699
2018/1/28,3573,2016,569,988,1557
2018/1/29,8119,4098,1361,2660,4021
2018/1/30,6790,3273,1036,2481,3517
2018/1/31,6508,3149,1034,2325,3359
2018/2/1,6306,2959,992,2355,3347
2018/2/2,5911,2799,970,2142,3112
2018/2/3,2530,1442,367,721,1088
2018/2/4,1907,1020,306,581,887
2018/2/5,5668,2726,862,2080,2942
2018/2/6,5379,2588,781,2010,2791
2018/2/7,4342,2012,647,1683,2330
2018/2/8,668,325,135,208,343
2018/2/9,228,155,26,47,73
2018/2/10,497,379,38,80,118
2018/2/12,20,11,4,5,9
2018/2/19,5,2,2,1,3
2018/2/22,4472,2019,614,1839,2453
2018/2/23,6183,2748,935,2500,3435
2018/2/24,6805,3211,1070,2524,3594
2018/2/25,2780,1326,366,1088,1454
2018/2/26,9423,4250,1418,3755,5173
2018/2/27,9443,4384,1411,3648,5059
2018/2/28,9199,4218,1447,3534,4981
2018/3/1,8583,4117,1333,3133,4466
2018/3/2,7437,3677,1186,2574,3760
2018/3/3,3640,1903,547,1190,1737
2018/3/4,2913,1565,512,836,1348
2018/3/5,9151,4393,1421,3337,4758
2018/3/6,9236,4408,1437,3391,4828
2018/3/7,9507,4550,1479,3478,4957
2018/3/8,8460,4151,1290,3019,4309
2018/3/9,8798,4323,1322,3153,4475
2018/3/10,3747,2102,515,1130,1645
2018/3/11,2434,1259,367,808,1175
2018/3/12,8968,4330,1301,3337,4638
2018/3/13,8719,4169,1381,3169,4550
2018/3/14,8184,3933,1234,3017,4251
2018/3/15,7673,3758,1206,2709,3915
2018/3/16,6228,3112,948,2168,3116
2018/3/17,908,539,87,282,369
2018/3/18,346,172,35,139,174
2018/3/19,6865,3237,985,2643,3628
2018/3/20,6450,3062,901,2487,3388
2018/3/21,6225,2920,947,2358,3305
2018/3/22,6423,2957,992,2474,3466
2018/3/23,5322,2688,763,1871,2634
2018/3/24,1337,728,143,466,609
2018/3/25,713,338,87,288,375
2018/3/26,6610,3111,937,2562,3499
2018/3/27,6414,3098,915,2401,3316
2018/3/28,6372,3037,946,2389,3335
2018/3/29,5984,2811,889,2284,3173
2018/3/30,5158,2524,751,1883,2634
2018/3/31,1330,698,162,470,632
2018/4/1,889,397,136,356,492
2018/4/2,5686,2568,892,2226,3118
2018/4/3,5361,2535,773,2053,2826
2018/4/4,4521,2143,698,1680,2378
2018/4/5,1273,631,186,456,642
2018/4/6,1301,688,180,433,613
2018/4/7,1154,659,133,362,495
2018/4/8,4890,2251,745,1894,2639
2018/4/9,5722,2643,858,2221,3079
2018/4/10,5790,2645,831,2314,3145
2018/4/11,5518,2570,802,2146,2948
2018/4/12,5477,2586,721,2170,2891
2018/4/13,4951,2313,726,1912,2638
2018/4/14,1518,763,184,571,755
2018/4/15,1160,522,143,495,638
2018/4/16,5528,2635,828,2065,2893
2018/4/17,5715,2625,828,2262,3090
2018/4/18,5601,2674,818,2109,2927
2018/4/19,5586,2583,907,2096,3003
2018/4/20,5077,2399,790,1888,2678
2018/4/21,1603,861,177,565,742
2018/4/22,1218,536,167,515,682
2018/4/23,5722,2651,819,2252,3071
2018/4/24,5864,2715,847,2302,3149
2018/4/25,5813,2717,853,2243,3096
2018/4/26,5534,2574,864,2096,2960
2018/4/27,5504,2508,854,2142,2996
2018/4/28,3307,1502,406,1399,1805
2018/4/29,476,229,62,185,247
2018/4/30,516,270,77,169,246
2018/5/1,564,295,76,193,269
2018/5/2,5572,2582,795,2195,2990
2018/5/3,5777,2641,842,2294,3136
2018/5/4,5261,2552,769,1940,2709
2018/5/5,1514,707,221,586,807
2018/5/6,935,419,130,386,516
2018/5/7,5460,2488,803,2169,2972
2018/5/8,5293,2377,814,2102,2916
2018/5/9,5730,2650,909,2171,3080
2018/5/10,5718,2737,870,2111,2981
2018/5/11,5014,2437,806,1771,2577
2018/5/12,1571,826,189,556,745
2018/5/13,1078,469,146,463,609
2018/5/14,5822,2633,843,2346,3189
2018/5/15,5649,2557,845,2247,3092
2018/5/16,5934,2742,959,2233,3192
2018/5/17,6021,2820,969,2232,3201
2018/5/18,5234,2508,825,1901,2726
2018/5/19,1729,881,218,630,848
2018/5/20,1132,489,154,489,643
2018/5/21,5401,2440,806,2155,2961
2018/5/22,5591,2557,841,2193,3034
2018/5/23,5949,2762,992,2195,3187
2018/5/24,5820,2764,915,2141,3056
2018/5/25,5196,2499,800,1897,2697
2018/5/26,1838,970,296,572,868
2018/5/27,1481,699,248,534,782
2018/5/28,5492,2514,907,2071,2978
2018/5/29,5246,2452,871,1923,2794
2018/5/30,5616,2677,873,2066,2939
2018/5/31,6207,3075,973,2159,3132
2018/6/1,5178,2536,851,1791,2642
2018/6/2,2144,1146,340,658,998
2018/6/3,1671,921,270,480,750
2018/6/4,6072,2845,991,2236,3227
2018/6/5,5958,2825,961,2172,3133
2018/6/6,5963,2930,921,2112,3033
2018/6/7,5698,2747,954,1997,2951
2018/6/8,5351,2643,897,1811,2708
2018/6/9,1761,970,283,508,791
2018/6/10,1321,636,228,457,685
2018/6/11,5687,2667,859,2161,3020
2018/6/12,5995,2885,953,2157,3110
2018/6/13,6829,3242,1034,2553,3587
2018/6/14,6590,3194,957,2439,3396
2018/6/15,5790,2891,852,2047,2899
2018/6/16,2041,1202,273,566,839
2018/6/17,1268,692,200,376,576
2018/6/18,1535,821,249,465,714
2018/6/19,6225,2898,884,2443,3327
2018/6/20,6534,2966,988,2580,3568
2018/6/21,6037,2728,928,2381,3309
2018/6/22,5809,2752,871,2186,3057
2018/6/23,2132,1140,288,704,992
2018/6/24,1324,618,192,514,706
2018/6/25,6385,2846,957,2582,3539
2018/6/26,6059,2785,950,2324,3274
2018/6/27,7222,3479,1159,2584,3743
2018/6/28,6820,3358,1050,2412,3462
2018/6/29,6860,3482,1064,2314,3378
2018/6/30,2748,1562,428,758,1186
2018/7/1,1864,958,304,602,906
2018/7/2,6468,3014,1045,2409,3454
2018/7/3,6811,3137,1174,2500,3674
2018/7/4,7680,3557,1298,2825,4123
2018/7/5,7573,3575,1324,2674,3998
2018/7/6,6145,2901,1022,2222,3244
2018/7/7,2442,1323,376,743,1119
2018/7/8,1813,885,331,597,928
2018/7/9,6729,3081,1078,2570,3648
2018/7/10,6961,3271,1128,2562,3690
2018/7/11,7453,3491,1281,2681,3962
2018/7/12,7299,3586,1152,2561,3713
2018/7/13,6646,3247,1065,2334,3399
2018/7/14,2726,1469,460,797,1257
2018/7/15,1924,965,300,659,959
2018/7/16,6654,3101,1091,2462,3553
2018/7/17,7498,3412,1216,2870,4086
2018/7/18,7643,3584,1257,2802,4059
2018/7/19,7816,3623,1322,2871,4193
2018/7/20,7380,3570,1206,2604,3810
2018/7/21,2972,1447,540,985,1525
2018/7/22,2373,1159,442,772,1214
2018/7/23,7550,3483,1267,2800,4067
2018/7/24,7563,3591,1254,2718,3972
2018/7/25,7932,3886,1272,2774,4046
2018/7/26,7485,3630,1246,2609,3855
2018/7/27,7045,3397,1200,2448,3648
2018/7/28,2855,1475,497,883,1380
2018/7/29,2491,1181,461,849,1310
2018/7/30,7055,3296,1067,2692,3759
2018/7/31,7549,3459,1241,2849,4090
2018/8/1,7427,3403,1263,2761,4024
2018/8/2,7416,3442,1224,2750,3974
2018/8/3,6599,3212,1084,2303,3387
2018/8/4,3041,1600,495,946,1441
2018/8/5,2162,1081,375,706,1081
2018/8/6,6791,3157,1017,2617,3634
2018/8/7,7574,3548,1192,2834,4026
2018/8/8,7757,3555,1299,2903,4202
2018/8/9,7600,3538,1187,2875,4062
2018/8/10,7254,3444,1143,2667,3810
2018/8/11,3549,1800,587,1162,1749
2018/8/12,2724,1288,481,955,1436
2018/8/13,7406,3470,1079,2857,3936
2018/8/14,8126,3704,1278,3144,4422
2018/8/15,7783,3646,1188,2949,4137
2018/8/16,8150,3823,1358,2969,4327
2018/8/17,6698,3165,1102,2431,3533
2018/8/18,3136,1756,447,933,1380
2018/8/19,2535,1294,424,817,1241
2018/8/20,7920,3655,1246,3019,4265
2018/8/21,8114,3748,1348,3018,4366
2018/8/22,8858,3901,1609,3348,4957
2018/8/23,8157,3692,1423,3042,4465
2018/8/24,7377,3476,1245,2656,3901
2018/8/25,2296,1228,342,726,1068
2018/8/26,1140,526,180,434,614
2018/8/27,7045,3208,1110,2727,3837
2018/8/28,7510,3451,1200,2859,4059
2018/8/29,8760,3966,1566,3228,4794
2018/8/30,8303,3708,1517,3078,4595
2018/8/31,6570,3148,1094,2328,3422
2018/9/1,3722,2149,549,1024,1573
2018/9/2,3482,1627,730,1125,1855
2018/9/3,7562,3350,1204,3008,4212
2018/9/4,8105,3543,1505,3057,4562
2018/9/5,8043,3600,1490,2953,4443
2018/9/6,8139,3653,1473,3013,4486
2018/9/7,7348,3358,1315,2675,3990
2018/9/8,3924,2182,642,1100,1742
2018/9/9,2920,1449,531,940,1471
2018/9/10,7193,3212,1249,2732,3981
2018/9/11,7534,3312,1370,2852,4222
2018/9/12,6860,3030,1274,2556,3830
2018/9/13,5643,2422,982,2239,3221
2018/9/14,4160,1771,714,1675,2389
2018/9/15,432,381,22,29,51
2018/9/16,29,17,3,9,12
2018/9/17,3225,1316,517,1392,1909
2018/9/18,3209,1263,529,1417,1946
2018/9/19,2180,827,337,1016,1353
2018/9/20,2548,1015,414,1119,1533
2018/9/21,2830,1207,472,1151,1623
2018/9/22,538,522,7,9,16
2018/9/23,18,9,4,5,9
2018/9/24,482,238,70,174,244
2018/9/25,3466,1386,540,1540,2080
2018/9/26,4106,1682,733,1691,2424
2018/9/27,3796,1651,648,1497,2145
2018/9/28,3326,1497,531,1298,1829
2018/9/29,2231,1309,282,640,922
2018/9/30,650,275,109,266,375
2018/10/1,58,21,19,18,37
2018/10/2,15,8,3,4,7
2018/10/3,19,13,2,4,6
2018/10/4,23,16,3,4,7
2018/10/5,204,190,5,9,14
2018/10/6,1053,1043,4,6,10
2018/10/7,12,9,1,2,3
2018/10/8,4009,1520,617,1872,2489
2018/10/9,4996,2018,876,2102,2978
2018/10/10,5316,2211,955,2150,3105
2018/10/11,4898,2039,857,2002,2859
2018/10/12,4691,1972,794,1925,2719
2018/10/13,1358,854,179,325,504
2018/10/14,567,282,98,187,285
2018/10/15,4625,1860,719,2046,2765
2018/10/16,5374,2187,923,2264,3187
2018/10/17,5889,2570,1052,2267,3319
2018/10/18,5618,2361,960,2297,3257
2018/10/19,5178,2208,896,2074,2970
2018/10/20,1604,941,254,409,663
2018/10/21,959,507,157,295,452
2018/10/22,5502,2252,932,2318,3250
2018/10/23,5751,2389,933,2429,3362
2018/10/24,6265,2723,1051,2491,3542
2018/10/25,7049,3101,1338,2610,3948
2018/10/26,6326,2878,1108,2340,3448
2018/10/27,1588,1025,160,403,563
2018/10/28,1088,509,185,394,579
2018/10/29,5791,2526,940,2325,3265
2018/10/30,6352,2790,1120,2442,3562
2018/10/31,7178,3674,1145,2359,3504
2018/11/1,5845,2508,1009,2328,3337
2018/11/2,5108,2207,878,2023,2901
2018/11/3,2284,1318,351,615,966
2018/11/4,1288,640,213,435,648
2018/11/5,5515,2389,913,2213,3126
2018/11/6,5774,2529,931,2314,3245
2018/11/7,7176,3217,1280,2679,3959
2018/11/8,6391,2824,1091,2476,3567
2018/11/9,5342,2432,887,2023,2910
2018/11/10,2377,1445,312,620,932
2018/11/11,1379,652,236,491,727
2018/11/12,5557,2399,911,2247,3158
2018/11/13,5698,2495,932,2271,3203
2018/11/14,9017,4901,1523,2593,4116
2018/11/15,7073,3451,1236,2386,3622
2018/11/16,5182,2370,901,1911,2812
2018/11/17,1951,1155,260,536,796
2018/11/18,1459,693,253,513,766
2018/11/19,5651,2312,1017,2322,3339
2018/11/20,5801,2556,954,2291,3245
2018/11/21,7080,3229,1234,2617,3851
2018/11/22,6793,3045,1194,2554,3748
2018/11/23,5754,2611,986,2157,3143
2018/11/24,3832,2192,592,1048,1640
2018/11/25,2339,1211,373,755,1128
2018/11/26,6498,2897,1079,2522,3601
2018/11/27,6858,3075,1127,2656,3783
2018/11/28,8904,4229,1613,3062,4675
2018/11/29,9133,4727,1522,2884,4406
2018/11/30,7222,3530,1217,2475,3692
2018/12/1,4217,2400,621,1196,1817
2018/12/2,3743,1885,676,1182,1858
2018/12/3,7908,3402,1369,3137,4506
2018/12/4,6716,2874,1136,2706,3842
2018/12/5,7246,3310,1250,2686,3936
2018/12/6,8532,4075,1486,2971,4457
2018/12/7,7003,3277,1242,2484,3726
2018/12/8,3330,2141,413,776,1189
2018/12/9,2742,1449,469,824,1293
2018/12/10,6864,2979,1177,2708,3885
2018/12/11,8065,3664,1440,2961,4401
2018/12/12,6602,2865,1163,2574,3737
2018/12/13,6530,2835,1090,2605,3695
2018/12/14,6472,2975,1098,2399,3497
2018/12/15,3703,2169,533,1001,1534
2018/12/16,2026,975,343,708,1051
2018/12/17,6953,3010,1155,2788,3943
2018/12/18,7272,3231,1251,2790,4041
2018/12/19,7232,3191,1204,2837,4041
2018/12/20,6595,2902,1119,2574,3693
2018/12/21,6401,2974,1126,2301,3427
2018/12/22,3740,2193,586,961,1547
2018/12/23,2853,1431,488,934,1422
2018/12/24,6951,3238,1209,2504,3713
2018/12/25,7077,3200,1250,2627,3877
2018/12/26,7883,3617,1361,2905,4266
2018/12/27,7577,3455,1355,2767,4122
2018/12/28,6569,2989,1123,2457,3580
2018/12/29,5381,2917,821,1643,2464
2018/12/30,2232,1139,379,714,1093
2018/12/31,2057,1145,364,548,912
2019/1/1,2221,1235,392,594,986
2019/1/2,7036,3246,1162,2628,3790
2019/1/3,7516,3366,1344,2806,4150
2019/1/4,8087,3829,1387,2871,4258
2019/1/5,4376,2493,669,1214,1883
2019/1/6,3088,1572,506,1010,1516
2019/1/7,7214,3266,1323,2625,3948
2019/1/8,7245,3404,1268,2573,3841
2019/1/9,5961,2773,1008,2180,3188
2019/1/10,5381,2407,969,2005,2974
2019/1/11,4901,2184,852,1865,2717
2019/1/12,155,57,13,85,98
2019/1/13,95,42,13,40,53
2019/1/14,4239,1747,742,1750,2492
2019/1/15,1815,670,311,834,1145
2019/1/16,1706,672,275,759,1034
2019/1/17,1579,645,264,670,934
2019/1/18,1365,582,200,583,783
2019/1/19,922,869,10,43,53
2019/1/20,56,32,5,19,24
2019/1/21,694,275,99,320,419
2019/1/22,500,207,71,222,293
2019/1/23,644,254,89,301,390
2019/1/24,582,274,84,224,308
2019/1/25,438,252,38,148,186
2019/1/26,717,715,1,1,2
2019/1/28,45,23,4,18,22
2019/1/29,34,21,3,10,13
2019/1/30,31,9,5,17,22
2019/1/31,18,10,1,7,8
2019/2/1,246,240,2,4,6
2019/2/2,873,863,3,7,10
2019/2/9,1003,1000,2,1,3
2019/2/11,3370,1324,506,1540,2046
2019/2/12,5232,2017,916,2299,3215
2019/2/13,7478,3096,1269,3113,4382
2019/2/14,7611,3151,1310,3150,4460
2019/2/15,7479,3183,1169,3127,4296
2019/2/16,4638,2301,702,1635,2337
2019/2/17,3757,1656,643,1458,2101
2019/2/18,8862,3553,1512,3797,5309
2019/2/19,8377,3490,1518,3369,4887
2019/2/20,9830,3999,1679,4152,5831
2019/2/21,9370,3886,1578,3906,5484
2019/2/22,9228,3915,1524,3789,5313
2019/2/23,1884,1088,280,516,796
2019/2/24,1090,524,166,400,566
2019/2/25,7795,3166,1210,3419,4629
2019/2/26,7981,3229,1271,3481,4752
2019/2/27,8388,3600,1563,3225,4788
2019/2/28,5398,2234,912,2252,3164